M  PPPPP
P     VP
PP    PP
   P   P
S    P P
PP PP  P