M  PPPPP
P      P
PP    PP
   P   P
S   VP P
PPPPP  P