M  PPPPP
P      P
PP    PP
   P   P
SV   P P
PP PP  P