M-------
PP--PP--
---PP---
S---P--P
-P---V-P
PPPPP-PP